1111111111111111111111
1E10000C000000000000P1
10100101001000001C1011
1010010010101010001011
10000000000C00000000C1
1111111111111111111111
