1111111111111111111111111111
1111111110110100001111111111
1111111110110111101111111111
1111111110000100001111111111
1111111111110101111111111111
1111111111110100001111111111
1111111111111111111111111111
10000100001000001000001P00C1
1011010110101110111011101101
10000101101000001110111C1101
1011110110101011111011101101
10111100001011001110111E00C1
1111111111111111111111111111
