1111111111111111111111111111
111111111X110100001111111111
1111111110110111101111111111
1111111110000100001111111111
1111111111110101111111111111
11111111111101000X1111111111
1111111111111111111111111111
10000100001000001000001P00C1
1011010110101110111011101101
10000101101000001110111C1101
10111101101010111110111X1101
10111100001011001110111E00C1
1111111111111111111111111111
