1111111111111111111111
1E100P0C00000000000001
10000101001000001C1011
1110010010101010001011
1C100000000C00000000C1
1111111111111111111111
