11111
100P1
10001
1C0E1
11111
