1111111111111111111111
1X10001011101110101111
1010101111111111111011
1000000P000000000X1111
1011101011111010111011
1111111011101010001011
1000111011111C10111011
1010101011111110101011
111X111010001010111011
1000C00C10101X000000E1
1111111111111111111111
