1111111111
10000000X1
10C1110P01
10111X0001
1010X11101
1010C0X101
1010101101
1000100001
11111010E1
1111111111
